[
    ["-", "-", "-", "w", "-", "-", "-"],
    ["w", "w", "w", "w", "-", "c", "-"],
    ["-", "s", "-", "w", "-", "-", "-"],
    ["w", "s", "-", "c", "-", "w", "-"],
    ["-", "s", "-", "-", "-", "p", "-"],
    ["w", "w", "w", "-", "c", "-", "-"],
    ["-", "-", "-", "-", "-", "-", "-"]
]